{
	"map": [
	[65, 65, 65, 65, 65, 65, 65, 65, 65, 65, 65, 65, 65, 65, 65, 65, 65, 65, 73, 74, 74, 74, 74, 74, 74, 74, 74, 74, 74, 74, 74, 74, 74],
	[65, 0, 0, 0, 0, 0, 0, 0, 0, 0, 0, 0, 0, 0, 0, 0, 0, 0, 73, 74, 74, 74, 74, 74, 74, 74, 74, 74, 74, 74, 74, 74, 74],
	[65, 0, 0, 0, 0, 0, 0, 0, 0, 0, 0, 0, 0, 0, 0, 0, 0, 0, 73, 74, 87, 87, 87, 87, 87, 87, 87, 87, 87, 87, 87, 87, 74],
	[65, 0, 0, 0, 0, 0, 0, 0, 0, 0, 0, 0, 0, 0, 0, 0, 0, 0, 73, 75, 0, 0, 0, 0, 0, 0, 0, 0, 0, 0, 0, 0, 73],
	[65, 0, 0, 0, 0, 0, 0, 0, 0, 0, 0, 0, 0, 0, 0, 0, 0, 0, 73, 75, 0, 0, 0, 0, 0, 0, 0, 0, 0, 0, 0, 0, 73],
	[65, 0, 0, 0, 0, 0, 0, 0, 0, 0, 0, 0, 0, 0, 0, 0, 0, 0, 73, 75, 0, 0, 0, 0, 0, 0, 0, 0, 0, 0, 0, 0, 73],
	[65, 0, 0, 0, 0, 0, 0, 0, 0, 0, 0, 0, 0, 0, 0, 0, 0, 0, 73, 75, 0, 0, 0, 0, 0, 0, 0, 0, 0, 0, 0, 0, 73],
	[65, 0, 0, 0, 0, 0, 0, 0, 0, 0, 0, 0, 0, 0, 0, 0, 0, 0, 73, 75, 0, 0, 0, 0, 0, 60, 27, 79, 79, 80, 0, 0, 73],
	[65, 0, 0, 0, 0, 0, 0, 0, 0, 0, 0, 0, 0, 0, 0, 0, 0, 0, 73, 75, 0, 0, 0, 0, 0, 73, 75, 0, 0, 0, 0, 0, 73],
	[65, 0, 0, 28, 29, 30, 31, 32, 33, 34, 35, 36, 37, 38, 0, 0, 0, 0, 73, 75, 0, 0, 0, 81, 0, 73, 75, 0, 0, 0, 0, 0, 73],
	[65, 0, 0, 41, 42, 43, 44, 45, 46, 47, 48, 49, 50, 51, 0, 0, 0, 0, 73, 75, 81, 0, 0, 0, 0, 73, 75, 0, 0, 0, 0, 0, 73],
	[65, 0, 0, 54, 55, 56, 57, 58, 59, 0, 0, 0, 0, 0, 0, 0, 0, 0, 73, 75, 0, 0, 0, 0, 0, 73, 75, 0, 0, 78, 79, 79, 74],
	[65, 0, 0, 67, 68, 69, 70, 71, 72, 0, 0, 0, 0, 0, 0, 0, 0, 0, 73, 75, 0, 0, 0, 0, 0, 73, 75, 0, 0, 0, 0, 0, 73],
	[65, 0, 0, 0, 0, 0, 0, 0, 0, 0, 0, 0, 0, 0, 0, 0, 0, 0, 73, 75, 0, 0, 0, 81, 0, 73, 75, 0, 0, 0, 0, 0, 73],
	[65, 0, 0, 0, 0, 0, 0, 0, 0, 0, 0, 0, 0, 0, 0, 0, 0, 0, 73, 75, 0, 0, 0, 0, 0, 73, 75, 0, 0, 0, 0, 0, 73],
	[65, 0, 0, 0, 0, 0, 0, 0, 0, 0, 0, 0, 0, 0, 0, 0, 0, 0, 73, 75, 0, 0, 0, 0, 0, 73, 74, 79, 79, 80, 0, 0, 73],
	[65, 0, 0, 0, 0, 0, 0, 0, 0, 0, 0, 0, 0, 0, 0, 0, 0, 0, 73, 75, 81, 0, 0, 0, 0, 73, 75, 0, 0, 0, 0, 65, 73],
	[65, 0, 0, 0, 0, 0, 0, 0, 0, 0, 0, 0, 0, 0, 0, 0, 0, 0, 73, 75, 0, 0, 0, 0, 0, 73, 75, 65, 65, 0, 0, 0, 73],
	[65, 0, 0, 0, 0, 0, 0, 0, 0, 0, 0, 24, 0, 0, 0, 0, 0, 0, 73, 75, 0, 0, 0, 0, 65, 73, 75, 0, 0, 0, 0, 0, 73],
	[65, 0, 0, 0, 0, 0, 0, 0, 0, 0, 0, 0, 0, 0, 0, 0, 0, 0, 73, 75, 0, 65, 0, 81, 0, 73, 75, 0, 0, 78, 79, 79, 87],
	[65, 0, 0, 0, 0, 0, 0, 0, 0, 0, 0, 0, 0, 0, 0, 0, 0, 65, 73, 75, 0, 0, 81, 0, 0, 73, 75, 0, 0, 0, 0, 0, 65],
	[65, 0, 0, 0, 0, 0, 0, 0, 0, 0, 0, 65, 0, 0, 0, 0, 0, 0, 73, 75, 0, 0, 0, 0, 0, 73, 75, 0, 0, 0, 0, 25, 65],
	[65, 65, 0, 0, 0, 0, 0, 0, 65, 0, 0, 0, 0, 0, 0, 0, 0, 0, 73, 75, 0, 0, 0, 0, 0, 73, 74, 27, 27, 27, 27, 27, 27],
	[65, 0, 0, 0, 65, 0, 0, 0, 0, 0, 0, 0, 0, 0, 0, 0, 0, 0, 86, 87, 79, 80, 0, 0, 0, 73, 74, 40, 40, 40, 40, 40, 40],
	[61, 61, 61, 61, 61, 62, 0, 0, 0, 0, 0, 0, 0, 0, 0, 0, 0, 0, 0, 0, 0, 0, 0, 0, 0, 73, 74, 40, 40, 40, 40, 40, 40],
	[40, 40, 40, 40, 40, 40, 61, 61, 61, 62, 0, 0, 0, 0, 0, 0, 0, 0, 0, 0, 0, 0, 0, 0, 0, 73, 74, 40, 40, 40, 40, 40, 40],
	[40, 40, 40, 40, 40, 40, 40, 40, 40, 40, 61, 61, 61, 61, 61, 61, 61, 61, 61, 61, 61, 61, 61, 61, 61, 74, 74, 40, 40, 40, 40, 40, 40],
	[40, 40, 40, 40, 40, 40, 40, 40, 40, 40, 40, 40, 40, 40, 40, 40, 40, 40, 74, 40, 40, 40, 40, 40, 40, 40, 40, 40, 40, 40, 40, 40, 40],
	[40, 40, 40, 40, 40, 40, 40, 40, 40, 40, 40, 40, 40, 40, 40, 40, 40, 40, 40, 40, 40, 40, 40, 40, 40, 40, 40, 40, 40, 40, 40, 40, 40],
	[40, 40, 40, 40, 40, 40, 40, 40, 40, 40, 40, 40, 40, 40, 40, 40, 40, 40, 40, 40, 40, 40, 40, 40, 40, 40, 40, 40, 40, 40, 40, 40, 40]
	],
	"character": {
		"x": 737,
		"y": 706
	},
	"triggers": [
		{
			"type": "nextLevel",
			"url": "http://www.jmilstead.com/commanderz/levels/levels.json",
			"x": 31,
			"y": 21
		}
	]
}